1111111111111111111111111111111111111111
1000000000000000000000000000000000000001
1000000000000000000000000000000000000001
1000000000000000000000000000000110000001
1000000000000000000000000000000110000001
1000000000000000000000000000000110000001
1000000000000000000000000000000110000001
1000000000000000000000000000000110000001
1000000000000000000000000000000000000001
1000000000000000000000000000000000000001
1000000000000000000000000000000000000001
1000000000000000000000000000000000000001
1000000000000000000000000000000000000001
1000000000000000000000000000000000000001
1000001000000001111111111111111000000001
1000001000000001111111111111111000000001
1000001000000000000000000000000000000001
1000001000000000000000000000000000000001
1000000000000000000000000000000000000001
1000000000000000000000000000000000000001
1000000000000000000000000000000000000001
1111111111111111111111111111111111111111
1111111111111111111111111111111111111111
