#####################################################
#####################################################
##                                                 ##
##                                                 ##
##                                                 ##
###################      ###      #####            ##
##                #      ###      #####            ##
##                #      ###      #####            ##
##  ##  ##  ##    #      ###      #####            ##
##  ##  ##  ##    #      ###                       ##
##  ##  ##  ##    #      ###                       ##
##                                                 ##
##                                                 ##
##  ##  ##  ##    ##########################       ##
##  ##  ##  ##    #             ####               ##
##  ##  ##  ##    #             ####               ##
##                #    ####              ###       ##
##                #    ####              ###       ##
##      ###########    #####################       ##
##                                                 ##
##                                                 ##
##      ################    ################       ##
##                                                 ##
##                                                 ##
########################    #########################
##                                                 ##
##                                                 ##
##                                                 ##
##       ##      ##      ##      ##      ##        ##
##       ##      ##      ##      ##      ##        ##
##                                                 ##
##                                                 ##
##                                                 ##
#####################################################
#####################################################
