#####################################################
#####################################################
##                                                 ##
##                                                 ##
##                                                 ##
###################      ###      #####            ##
##                #      ###      #####            ##
##                #      ###      #####            ##
##  ##  ##  ##    #      ###      #####            ##
##  ##  ##  ##    #      ###                       ##
##  ##  ##  ##    #      ###                       ##
##                                                 ##
##                                                 ##
##  ##  ##  ##    #########################        ##
##  ##  ##  ##    #             ####               ##
##  ##  ##  ##    #             ####               ##
##                #    ####              ##        ##
##                #    ####              ##        ##
##      ###########    ####################        ##
##                                                 ##
##                                                 ##
##      ###############       #############        ##
##                                                 ##
##                                                 ##
########################    #########################
##                                                 ##
##                                                 ##
##                ##                ##             ##
##                ##                ##             ##
##        ##                                ##     ##
##        ##              ##                ##     ##
##                        ##                       ##
##                                                 ##
#####################################################
#####################################################
